15x15
xxxxxxxxxxxxxxx
x             x
x x x x x x x x
x             x
x x xox x x x x
x  o          x
x x x x x x x x
x             x
x x x x x x x x
x             x
x x x x x x x x
x             x
x x x x x x x x
x             x
xxxxxxxxxxxxxxx
