31x31
xxxxxxxxxxxxxxxxxxxxxxxxxxxxxxx
x    o                        x
x x xox x x x x x x x x x x x x
x    oooo                     x
x x x x x x x x x x x x x x x x
x                             x
x x x x x x x x x x x x x x x x
x                             x
x x x x x x x x x x x x x x x x
x                             x
x x x x x x x x x x x x x x x x
x                             x
x x x x x x x x x x x x x x x x
x                             x
x x x x x x x x x x x x x x x x
x                             x
x x x x x x x x x x x x x x x x
x                             x
x x x x x x x x x x x x x x x x
x                             x
x x x x x x x x x x x x x x x x
x                             x
x x x x x x x x x x x x x x x x
x                             x
x x x x x x x x x x x x x x x x
x                             x
x x x x x x x x x x x x x x x x
x                             x
x x x x x x x x x x x x x x x x
x                             x
xxxxxxxxxxxxxxxxxxxxxxxxxxxxxxx