33x31
xxxxxxxxxxxxxxxxxxxxxxxxxxxxxxxxx
x                               x
x x x x x x x x x x x x x x x x x
x                               x
x x x x x x x x x x x x x x x x x
xooo ooo ooo o o   o ooo ooo ooox
xox xoxoxox xoxox xoxoxoxoxoxoxox
xo   o o ooo o o o o ooo ooo o ox
xox xoxoxox xoxox xoxox xoxoxoxox
xooo ooo o   o o   o o   o  oooox
x x x x x x x x x x x x x x x x x
x                               x
x x x x x x x x x x x x x x x x x
xooo ooo ooo o o   o ooo ooo ooox
xox xoxoxox xoxox xoxoxoxoxoxoxox
xo   o o ooo o o o o ooo ooo o ox
xox xoxoxox xoxox xoxox xoxoxoxox
xooo ooo o   o o   o o   o  oooox
x x x x x x x x x x x x x x x x x 
x                               x
x x x x x x x x x x x x x x x x x
xooo ooo ooo o o   o ooo ooo ooox
xox xoxoxox xoxox xoxoxoxoxoxoxox
xo   o o ooo o o o o ooo ooo o ox
xox xoxoxox xoxox xoxox xoxoxoxox
xooo ooo o   o o   o o   o  oooox
x x x x x x x x x x x x x x x x x
x                               x
x x x x x x x x x x x x x x x x x
x                               x
xxxxxxxxxxxxxxxxxxxxxxxxxxxxxxxxx